17
13
        #####
        #   #####
        # #$##  #
        #     $ #
######### ###   #
#....  ## $  $###
#....    $ $$ ##
#....  ##$  $ @#
#########  $  ##
        # $ $  #
        ### ## #
          #    #
          ######